,aa,sa,as,dl,o,tbs
1EMQ,8,0,0,0,16,24
1EVM,8,0,0,0,8,16
1FQP,2,4,0,10,2,18
1I34,0,4,0,10,5,19
1LVS,0,4,4,10,2,20
1NP9,8,0,0,0,16,24
1XAV,8,0,0,0,13,21
139D,12,0,0,0,12,24
148D,0,4,0,8,2,14
186D,3,4,0,6,10,23
201D,0,8,4,15,0,27
156D,0,8,4,10,0,22
1S45,12,0,0,0,8,20
2AVH,0,8,4,8,0,20
2GKU,3,4,0,8,8,23
2HY9,3,3,0,8,11,25
2JSM,3,4,0,8,7,22
2JPZ,3,4,0,8,10,25
2JSL,3,4,0,8,9,24
2KF8,0,4,0,12,5,21
2KKA,0,4,0,12,6,22
2LD8,8,0,0,0,14,22
143D,0,4,4,12,1,21